# This is a dump of the VCCX layouts. The array index is the
# layout ID and the array entries are the inverted shift
# register outputs. The least significant byte is the first
# shift register in the chain.

vccx_layouts = [
	0x000000, 0x000000, 0x000000, 0x000000, 0x000000, 0x000000,
	0x000000, 0x000000, 0x000001, 0x000000, 0x000000, 0x002000,
	0x000000, 0x000002, 0x000000, 0x000000, 0x080000, 0x000004,
	0x000000, 0x000000, 0x010000, 0x004000, 0x000000, 0x000000,
	0x000008, 0x000010, 0x000020, 0x000040, 0x000080, 0x000000,
	0x000100, 0x000000, 0x000200, 0x000000, 0x000400, 0x000000,
	0x000800, 0x000000, 0x008000, 0x000000, 0x001000, 0x000000,
	0x020000, 0x000000, 0x040000, 0x000000, 0x000000, 0x000000,
	0x000000, 0x000000, 0x000000, 0x000000, 0x000000, 0x000000,
	0x000000, 0x000000, 0x000000, 0x000000, 0x000000, 0x000000,
	0x000000, 0x000000, 0x000000, 0x000000, 0x000000, 0x000000,
	0x000000, 0x000000, 0x000000, 0x000000, 0x000000, 0x000000,
	0x000000, 0x000000, 0x000000, 0x000000, 0x000000, 0x000000,
	0x000000, 0x000000, 0x000000, 0x000000, 0x000000, 0x000000,
	0x000000, 0x000000, 0x000000, 0x000000, 0x000000, 0x000000,
	0x000000, 0x000000, 0x000000, 0x000000, 0x000000, 0x000000,
	0x000000, 0x000000, 0x000000, 0x000000, 0x000000, 0x012000,
	0x000000, 0x000000, 0x000000, 0x000000, 0x000000, 0x000000,
	0x000000, 0x000000, 0x000000, 0x000000, 0x000000, 0x000000,
	0x000000, 0x000000, 0x000000, 0x000000, 0x000000, 0x000000,
	0x000000, 0x000000, 0x000000, 0x000000, 0x000000, 0x000000,
	0x000000, 0x000000, 0x000000, 0x000000, 0x000000, 0x000000,
	0x000000, 0x000000, 0x000000, 0x000000, 0x000000, 0x000000,
	0x000000, 0x000000, 0x000000, 0x000000, 0x000000, 0x000000,
	0x000000, 0x000000, 0x000000, 0x000000, 0x000000, 0x000000,
	0x000000, 0x000000, 0x000000, 0x000000, 0x000000, 0x000000,
	0x000000, 0x000000, 0x000000, 0x000000, 0x000000, 0x000000,
	0x000000, 0x000000, 0x000000, 0x000000, 0x000000, 0x000000,
	0x000000, 0x000000, 0x000000, 0x000000, 0x000000, 0x000000,
	0x000000, 0x000000, 0x000000, 0x000000, 0x000000, 0x000000,
	0x000000, 0x000000, 0x000000, 0x000000, 0x000000, 0x000000,
	0x000000, 0x000000, 0x000000, 0x000000, 0x000000, 0x000000,
	0x000000, 0x000000, 0x000000, 0x000000, 0x000000, 0x000000,
	0x000000, 0x000000, 0x000000, 0x000000, 0x000000, 0x000000,
	0x000000, 0x000000, 0x000000, 0x000000, 0x000000, 0x000000,
	0x000000, 0x000000, 0x000000, 0x000000, 0x000000, 0x000000,
	0x000000, 0x000000, 0x000000, 0x000000, 0x000000, 0x000000,
	0x000000, 0x000000, 0x000000, 0x000000, 0x000000, 0x000000,
	0x000000, 0x000000, 0x000000, 0x000000, 0x000000, 0x000000,
	0x000000, 0x000000, 0x000000, 0x000000, 0x000000, 0x000000,
	0x000000, 0x000000, 0x000000, 0x000000, 0x000000, 0x000000,
	0x000000, 0x000000, 0x000000, 0x000000, 0x000000, 0x000000,
	0x000000, 0x000000, 0x000000, 0x000000,
]
